XXXXXXXXXXXXXXXXXXXXXXXXXXXXXXXXXXXXXXXXXXXXXXXXXXXXXXXXXXXXXXXXXXXXXXXXXXXXXXXXXXXXXXXXXXXXXXXXXXXXX
P         X       X           X     X                 X     X X   X     X   X           X           X
X XXX XXX X XXX X X XXX XXXXX XXX X X XXXXXXXXXXX XXXXX X X X X X X XXX X X X XXXXXXXXX X X XXXXXXXXX
X   X X   X X   X X X   X   X X   X X X           X     X X X   X   X X X X X   X     X   X         X
X XXX X XXXXX XXX XXX XXX XXX X XXX X X XXXXXXXXXXX XXXXX X X XXXXXXX X X X XXX XXX X XXXXXXXXXXXXX X
X X   X       X X   X X       X X X X X     X   X   X X   X X   X     X X X X   X   X X           X X
X X XXXXXXXXXXX XXX X XXX XXXXX X X X XXXXX X X X XXX X XXX XXX XXX X X X X X XXX XXXXX XXXXXXXXX X X
X X X     X     X   X   X     X X   X     X   X       X X   X X   X X X   X   X                 X X X
X X X XXX X XXXXX XXX X XXXXX X XXX XXXXXXX XXXXXXXXXXX X XXX XXX XXX XXXXXXXXX XXXXXXXXXXXXXXXXX X X
X X     X X     X X   X X     X   X       X X           X X   X   X     X         X         X     X X
XXXXXXXXX X XXX X XXXXX X XXXXXXX X XXXXX XXX XXXXXXXXXXX X XXX XXX XXX XXXXXXXXXXX XXXXXXX X XXX X X
X         X X X   X     X         X X   X     X   X       X   X   X X X X     X   X X   X   X X X X X
X XXXXXXXXX X XXXXX XXXXXXXXXXXXXXX X X X XXXXXXX X XXXXXXXXX XXX X X X X XXX X X X XXX X XXX X X X X
X     X   X X X     X     X       X X X X X     X   X           X   X X X X   X X   X   X X   X   X X
X XXX X XXX X X XXX X XXX XXX XXXXX X X XXX XXX X XXX XXXXXXXXXXXXXXX X X XXX X XXXXX XXX XXX X XXX X
X   X X X   X   X   X   X     X     X X     X   X X   X   X       X     X   X   X X           X   X X
XXX X X X XXXXXXX XXX X XXXXXXX XXXXX XXXXXXXXXXX XXX X X X XXX X X XXXXXXX XXXXX X XXXXXXXXXXX XXX X
X   X X   X       X   X       X X   X X       X X   X X X X   X X X X       X   X     X   X X   X   X
X XXX X XXXXX XXXXX XXXXXXXXX X XXX X XXX X X X XXX X X X XXX X XXX X XXXXX X X XXXXXXX X X X XXX X X
X X   X   X   X   X   X     X X X   X   X X X   X   X   X     X X   X   X   X X     X   X X X X X X X
X X XXXXX X XXX XXXXX X XXX X X X X XXX X X XXXXX XXXXX XXXXXXX X XXX X X XXX XXXXX X XXX X X X X XXX
X X X     X   X   X   X X   X   X X   X X X X   X     X X       X X   X X X       X   X   X X X X   X
X X XXXXX XXX X X X XXX XXXXXXXXX XXXXX XXX X X XXXXX XXX XXXXX X X XXX XXX XXXXXXXXXXX XXX X X XXX X
X X     X   X X X X X             X     X   X X     X   X   X   X X   X   X X X         X   X X   X X
X XXXXX XXX X X X X XXXXXXX XXXXX X XXXXX XXX XXX XXXXX XXX XXXXX XXX XXX X X X XXXXXXXXX XXX X X X X
X X     X X   X X   X     X   X   X   X X     X X X   X   X X   X   X   X     X   X X         X X X X
X X XXXXX XXXXX XXXXX XXX XXX X XXXXX X X XXXXX X X X XXX X X X XXX XXXXXXXXX XXX X X XXXXXXXXX XXX X
X X     X       X   X   X   X X X   X X X     X X   X     X   X   X     X   X X   X   X   X     X   X
XXXXXXX XXXXX XXX X XXX XXX X X X XXX X XXXXX X XXXXXXXXXXXXXXXXX XXXXX X X XXX XXX XXX X X X X X X X
X       X   X     X     X X X X X X   X     X   X       X       X     X   X     X   X   X X X X X X X
X XXXXX X X XXXXXXXXXXXXX X X X X X XXX XXX XXX X XXXXX X XXXXX XXX X XXXXXXXXXXX XXX X X XXX XXX X X
X X     X X   X   X       X   X X X X   X     X   X     X     X     X           X X   X X   X X   X X
X XXXXXXX XXX X X XXX XXX XXXXX X X X X XXXXX XXXXX XXXXXXX X XXXXXXX XXXXXXXXXXX X XXX XXX X X XXXXX
X X         X X X     X   X       X X X     X X   X X     X X X   X   X         X X X   X X   X X   X
X X XXXXXXXXX X XXXXX XXXXX XXXXXXX XXXXXXX XXX X X XXX X XXX X X X XXX XXXXXXX X XXX XXX XXX X X X X
X   X     X   X X     X     X   X   X     X   X X X   X X     X X X   X X   X X X     X   X   X   X X
XXXXX XXX X XXX XXX XXX XXXXX X X XXX XXX X X X X XXX X XXXXXXX XXX XXX X X X X XXXXXXX X X XXXXXXX X
X     X X   X     X X   X     X X X   X   X X   X     X       X     X   X X   X         X X       X X
X XXXXX XXXXX XXX XXX XXXXX XXX X X XXX XXX XXXXXXXXXXX XXXXX XXXXXXX XXX XXX X XXXXXXXXX XXX XXXXX X
X X   X         X   X   X   X   X   X X X X           X   X X   X     X   X   X X       X   X X     X
X X X XXX XXXXX XXX XXX X XXXXXXXXXXX X X XXXXXXXXXXX XXX X XXX X XXXXX XXX XXX X XXXXXXXXX X X XXX X
X X X   X X   X   X X   X     X     X   X         X   X X X   X   X     X X   X X     X     X X   X X
X X XXX XXX X XXXXX X XXXXX X X XXX X XXXXXXX XXX X XXX X X XXXXXXXXX XXX XXX X X XXX X XXXXX XXX XXX
X   X   X   X X   X       X X X X   X X       X   X   X   X       X   X   X   X X X X   X   X X X   X
X XXX X X XXX X X XXXXXXX XXX X X XXX X XXXXXXX XXXXX X XXXXX XXX X XXX XXX XXX X X XXXXXXX X X XXX X
X X   X X X X   X     X     X X X     X     X X   X   X X     X   X X X     X   X     X   X X X X   X
XXX XXX X X XXXXXXXXX XXXXX X X XXXXXXXXXXX X X XXX XXX X XXXXXXX X X X XXXXX XXXXXXX X X X X X X X X
X   X   X   X       X   X   X X   X       X X X X   X   X       X   X X     X X         X   X   X X X
X XXX XXXXX X XXXXX XXX X XXX XXX X XXXXX X X X X XXXXX XXXXXXX XXXXX X XXXXX X XXXXXXXXXXX XXX X X X
X X   X     X     X X   X       X X X     X X X X X   X         X   X   X   X X X   X   X   X   X X X
X XXXXX XXXXXXXXX X X XXXXXXXXX X X X XXXXX X X X X X XXXXXXXXXXXXX X XXX X X XXX X XXX X XXX XXX X X
X X     X   X   X X   X   X     X   X X     X   X   X     X         X   X X   X   X   X     X X   X X
X X XXXXX X X X X XXXXX X X XXXXXXXXX XXX XXXXX XXXXXXXXX XXXXXXX XXXXX X XXXXX XXXXX XXXXXXX X XXXXX
X X X X   X   X   X     X X   X     X   X     X         X       X     X X   X   X   X X     X X     X
X X X X X XXXXXXXXX XXXXXXXXX XXXXX XXX X XXX XXXXXXX XXXXXXXXX XXX XXX XXX X XXX X X X XXX X XXXXX X
X X   X X X     X         X   X   X X   X   X X   X   X       X   X   X X X   X   X X   X   X X     X
X XXX X X X XXX XXX XXXXX X XXX X X X XXXXX X X X X XXX XXX XXXXX X X X X XXXXX XXX XXXXX X X X XXXXX
X     X X X X X   X     X       X   X X     X   X X   X X X     X X X     X   X   X X X   X X X     X
X XXXXX XXX X XXX XXXXXXXXXXX XXXXX X XXXXXXXXX X XXX X X XXXXX X XXXXXXX X X XXX X X X XXXXX XXXXX X
X     X X   X X   X   X     X X   X X         X X   X X X     X   X     X   X   X X   X       X     X
X XXXXX X XXX X XXX X X XXX XXX X X XXXXXXXXX XXXXX X X X XXXXXXXXX XXX XXXXXXX X XXX XXXXXXXXX XXXXX
X X   X X   X X X   X   X X   X X X X X       X   X X X X           X X X       X X X X       X     X
XXX X X XXX X X X XXXXXXX XXX X X X X X XXXXXXX X X X X XXX XXXXX XXX X XXXXX XXX X X X XXXXX XXXXX X
X   X     X   X X X     X   X X X X   X X   X   X   X X   X X     X     X   X   X X   X X       X X X
X X XXXXXXXXX X X X XXX X X X X X XXXXX X XXX X XXXXX XXX XXX XXXXX XXXXX X XXX X X XXXXX XXXXX X X X
X X X   X     X X X   X X X X   X   X   X   X X   X X X X     X X   X     X X X   X       X   X   X X
X XXX X X XXXXX X X X X X X XXXXXXX X XXX X X XXX X X X XXXXXXX X XXX X XXX X XXXXX XXXXXXX XXXXX X X
X X   X X     X   X X X X X       X X   X X     X X X X   X     X   X X X   X X     X   X X       X X
X X XXX XXXXX XXXXX X XXX XXXXXXX X XXX X XXXXXXX X X X X X X XXXXX X X XXX X X XXXXX X X X XXXXXXX X
X X X       X   X   X       X   X X   X X   X X   X   X X X X     X X X   X X       X X X       X X X
X X X XXXXXXXXX XXXXXXXXXXXXX X X X XXX XXX X X XXX XXX X X XXX X X X XXX X XXXXXXXXX X XXXXXXX X X X
X   X     X     X           X X   X   X X X X X X X   X X   X   X X X X   X     X     X X     X   X X
XXXXXXXXX X XXXXX XXXXXXXXX X XXX XXX X X X X X X XXX XXXXXXX XXXXX XXX XXXXXXX X XXXXX X XXX XXX X X
X     X X   X         X       X     X   X X   X X           X     X     X     X X   X   X X     X X X
XXX X X XXXXX XXXXXXX XXXXX XXXXXXXXXXXXX XXX X X XXXXXXXXX XXXXX XXXXXXXXXXX X XXX X XXX XXXXX XXX X
X   X X     X     X X X   X X     X           X X   X   X X X               X X   X X   X   X X   X X
X XXX X XXX XXXXX X X X X XXX XXX X XXXXXXXXXXX XXXXX X X X X XXXXXXXXXXXXX X XXX X XXX XXX X XXX X X
X   X   X   X   X   X   X X   X X   X       X   X   X X X     X     X   X X   X X X   X X   X X   X X
X X XXXXX XXX X XXXXX XXX X XXX XXXXXXX XXX X XXX X X X XXXXXXX XXX X X X XXX X X XXX X X XXX X XXX X
X X X       X X     X   X X X           X   X     X   X       X X X   X X     X X     X   X   X   X X
X X XXXXXXX X XXXXX XXXXX X XXXXX X X XXXXXXXXXXXXXXXXXXXXXXX X X XXXXX X XXXXX XXXXXXXXXXX X XXX X X
X X       X   X   X       X     X X X X           X         X   X X     X       X   X       X   X X X
X XXXXXXX XXXXX X XXX XXXXXXXXX X X X X XXXXXXX X X X XXXXX XXXXX X XXXXXXXXXXX X X X XXXXXXXXX X X X
X   X   X     X X   X X         X X X X X     X X X X X   X X     X       X   X   X X X   X   X   X X
XXX X X XXXXX X XXX X X XXXXXXXXX X XXX XXXXX X X XXX X XXX X XXX XXXXXXX X X X XXXXX XXX X X XXXXX X
X   X X     X   X X X X X   X   X X   X       X X     X       X     X   X X X X X   X X   X X       X
X XXX XXXXX XXXXX X XXX X X X X X XXX XXX XXXXX XXXXX XXXXXXXXX XXXXX X X X XXX X X X X XXX XXXXXXX X
X     X     X     X     X X   X     X     X     X   X X   X X   X     X   X     X X   X     X X     X
XXXXXXX XXXXXXXXX XXXXXXXXXXX XXXXX XXXXXXX XXXXX X XXX X X X XXX XXXXXXXXXXX XXX XXXXX XXXXX X XXXXX
X   X X           X         X X   X X X   X       X     X X X   X   X   X   X X   X   X     X X     X
X X X XXXXXXXXXXX X XXXXXXX X X X X X X X XXXXXXXXXXXXXXX X XXX XXX X X X X X X XXX X XXXXX X XXXXX X
X X       X       X     X   X X X X   X X       X       X X   X X X   X X X X X   X X     X X   X   X
X XXXXXXXXX XXXXXXX XXX X XXXXX X XXXXX XXXXXXX X XXXXX X X X X X XXXXX X X XXXXX X XXX X X X X X X X
X     X     X   X     X X       X       X X     X X     X X X X X     X   X   X   X   X X X   X X X X
XXXXX X XXXXX X X XXXXX XXXXXXXXXXXXXXXXX X XXXXX X XXXXX X X X X XXXXXXXXXXX X XXXXX X XXXXXXX X X X
X     X X     X X   X   X         X     X   X   X X   X   X X   X   X       X X     X X         X X X
X XXXXX X XXXXX XXXXX XXXXX XXXXXXX XXX X XXX X X XXX X XXX XXXXX X X XXXXX X XXXXX XXXXX XXXXX X X X
X X   X   X   X   X   X     X     X X X X X   X X X X X X X   X   X X     X       X     X X   X X X X
X X X XXXXX X XXX X XXX XXXXX XXX X X X X X XXX X X X X X XXX XXXXX XXXXX XXXXXXXXXXXXX XXX X XXX X X
X   X       X       X           X     X     X     X     X               X                   X     X K
XXXXXXXXXXXXXXXXXXXXXXXXXXXXXXXXXXXXXXXXXXXXXXXXXXXXXXXXXXXXXXXXXXXXXXXXXXXXXXXXXXXXXXXXXXXXXXXXXXXXX
