XXXXXXXXXXXXXXXXXXXXXXXXXXXXXXXXXXXXXXXXXXXXXXXXXXXXXXXXXXXXXXXXXXXXXXXXXXXXXXXXXXXXXXXXXXXXXXXXXXXXX
PBOOOBOOOBXBOOOBOBXBOOOBOOOOOBXOOBOBXBOOOOOOOOOOOBOOOOXBOBOBX XB BXB   BXB BXB         BXB B        X
XOXXXOXXXOXOXXXOXOXOXXXOXXXXXOXXXOXOXOXXXXXXXXXXXOXXXXXOXOXOX X X X XXX X X X XXXXXXXXX X X XXXXXXXXX
XBOOXOXBOBXOXBOBXOXOXBOBXBOOXOXBOBXOXOXBOOOOOOOOOBXBOOOBXOXOXB BXB BX X X X XB BX  B BXB BXB       BX
XOXXXOXOXXXXXOXXXOXXXOXXXOXXXOXOXXXOXOXOXXXXXXXXXXXOXXXXXOXOX XXXXXXX X X X XXX XXX X XXXXXXXXXXXXX X
XOXBOBXBOOOOOBXOXBOBXOXOOBOOOBXOXOXOXOXBOOOBXBOBXBOBXOXBOBXOXB BX  B BX X X XB BXB BX XB         BX X
XOXOXXXXXXXXXXXOXXXOXOXXXOXXXXXOXOXOXOXXXXXOXOXOXOXXXOXOXXXOXXX XXX X X X X X XXX XXXXX XXXXXXXXX X X
XOXOXBOOOBXBOOOBXBOBXBOBXBOOOBXOXBOBXBOOOOXBOBXBOBOOOBXOXBOBX XB BX X XB BXB BXB B     B        X X X
XOXOXOXXXOXOXXXXXOXXXOXOXXXXXOXOXXXOXXXXXXXOXXXXXXXXXXXOXOXXX XXX XXX XXXXXXXXX XXXXXXXXXXXXXXXXX X X
XOXBOBOOXOXBOOOBXOXOOBXOXBOOOBXBOBXBOOOOOBXOXBOOOOOOOOOBXOXB BXB BXB B BX      B  XB       BXB   BX X
XXXXXXXXXOXOXXXOXOXXXXXOXOXXXXXXXOXOXXXXXOXXXOXXXXXXXXXXXOX XXX XXX XXX XXXXXXXXXXX XXXXXXX X XXX X X
XBOOOOOOOBXOXOXBOBXBOOOBXBOOOOOOOBXOXBOBXBOOOBXOOBXBOOOOOBXB BXB BX X X XB   BXB BX X  BXB BX X X X X
XOXXXXXXXXXOXOXXXXXOXXXXXXXXXXXXXXXOXOXOXOXXXXXXXOXOXXXXXXXXX XXX X X X X XXX X X X XXX X XXX X X X X
XBOOOBXBOOXOXOXBOOOBXBOOOBXOOBOOOOXOXOXOXOXBOOOBXBOBXB       B  XB BX X X X  BX XB BXB BX X  BXB BX X
XOXXXOXOXXXOXOXOXXXOXOXXXOXXXOXXXXXOXOXOXXXOXXXOXOXXX XXXXXXXXXXXXXXX X X XXX X XXXXX XXX XXX X XXX X
XBOBXOXOXBOBXBOBXBOBXBOBXBOOOBXBOOOBXOXBOOOBXOOBXOX  BXB BXB   B BXB B BXB BXB BX XB B   B   BXB  X X
XXXOXOXOXOXXXXXXXOXXXOXOXXXXXXXOXXXXXOXXXXXXXXXXXOXXX X X X XXX X X XXXXXXX XXXXX X XXXXXXXXXXX XXX X
XBOBXOXBOBXOOBOOOBXBOBXBOOOOOBXOXOOBXOXOOBOBOBXOXBOBX X X XB BX X X XB     BXB BXB B  XB BX XB BXB BX
XOXXXOXOXXXXXOXXXXXOXXXXXXXXXOXOXXXOXOXXXOXOXOXOXXXOX X X XXX X XXX X XXXXX X X XXXXXXX X X X XXX X X
XOXBOBXBOBXBOBXBOOXBOBXBOOOBXOXOXBOBXBOBXOXOXBOBXBOBXB BXB   BX XB BXB BXB BX XB   BXB BX X X X X X X
XOXOXXXXXOXOXXXOXXXXXOXOXXXOXOXOXOXOXXXOXOXOXXXXXOXXXXX XXXXXXX X XXX X X XXX XXXXX X XXX X X X X XXX
XOXOXOOOOBXBOBXBOBXBOBXOXOOBXBOBXOXBOOXOXOXOXBOBXBOOOBX XB     BX XB BX X XB B    XB BXB BX X X XB BX
XOXOXXXXXOXXXOXOXOXOXXXOXXXXXXXXXOXXXXXOXXXOXOXOXXXXXOXXX XXXXX X X XXX XXX XXXXXXXXXXX XXX X X XXX X
XOXBOOOBXBOBXOXOXOXOXOOBOOOBOOOOOBXBOOOBXBOBXOXBOBOOXBOBXB BX  BX XB BXB BX X XB       BXB BX XB BX X
XOXXXXXOXXXOXOXOXOXOXXXXXXXOXXXXXOXOXXXXXOXXXOXXXOXXXXXOXXX XXXXX XXX XXX X X X XXXXXXXXX XXX X X X X
XOXBOOOBXOXBOBXOXBOBXBOOOBXBOBXBOBXBOBXOXBOOOBXOXOXBOBXBOBX XB BXB BXB  XB B BXB BX XB   B   BX X X X
XOXOXXXXXOXXXXXOXXXXXOXXXOXXXOXOXXXXXOXOXOXXXXXOXOXOXOXXXOX X X XXX XXXXXXXXX XXX X X XXXXXXXXX XXX X
XOXBOOOBXBOOOBOBXBOBXBOBXBOBXOXOXBOOXOXOXBOOOBXOXBOBXBOOOBXB BXB BXB   BXB BX XB BXB BXB BXB B BXB BX
XXXXXXXOXXXXXOXXXOXOXXXOXXXOXOXOXOXXXOXOXXXXXOXOXXXXXXXXXXXXXXXXX XXXXX X X XXX XXX XXX X X X X X X X
XBOOOOOBXBOBXBOOOBXBOOOBXOXOXOXOXOXBOBXBOOOBXBOBXBOOOOOBXB     BXB B BXB BXB   BXB BXB BX X X X X X X
XOXXXXXOXOXOXXXXXXXXXXXXXOXOXOXOXOXOXXXOXXXOXXXOXOXXXXXOX XXXXX XXX X XXXXXXXXXXX XXX X X XXX XXX X X
XOXOOOOBXOXBOBXBOBXOOBOOOBXBOBXOXOXOXBOBXOOBOBXBOBXBOOOBXB B BXB   BXB          X XB BX XB BX XB BX X
XOXXXXXXXOXXXOXOXOXXXOXXXOXXXXXOXOXOXOXOXXXXXOXXXXXOXXXXXXX X XXXXXXX XXXXXXXXXXX X XXX XXX X X XXXXX
XOXBOOOOOBOOXOXOXBOOOBXOOBXBOOOBOBXOXOXBOOOBXOXBOBXOX  B BX X XB BXB BXB       BX X XB BX XB BX XB BX
XOXOXXXXXXXXXOXOXXXXXOXXXXXOXXXXXXXOXXXXXXXOXXXOXOXOXXX X XXX X X X XXX XXXXXXX X XXX XXX XXX X X X X
XBOBXBOOOBXBOBXOXOOBOBXBOOOBXBOBXBOBXBOOOBXBOBXOXOXBOBX XB   BX X XB  X XB BX X XB   BXB BXB BXB BX X
XXXXXOXXXOXOXXXOXXXOXXXOXXXXXOXOXOXXXOXXXOXOXOXOXOXXXOX XXXXXXX XXX XXX X X X X XXXXXXX X X XXXXXXX X
XBOOOBXOXBOBXBOBOBXOXBOBXOOBOBXOXOXBOBXBOBXOXBOBXBOOOBXB     BXB   BXB BX XB BXB       BX XB B    X X
XOXXXXXOXXXXXOXXXOXXXOXXXXXOXXXOXOXOXXXOXXXOXXXXXXXXXXX XXXXX XXXXXXX XXX XXX X XXXXXXXXX XXX XXXXX X
XOXBOBXBOBOOOBOBXBOBXBOBXBOBXOOBXBOBXOXOX XBOOOOOOOOOBXB BX XB BXB   BXB BXB BX XB      XB BX XB   BX
XOXOXOXXXOXXXXXOXXXOXXXOXOXXXXXXXXXXXOXOX XXXXXXXXXXXOXXX X XXX X XXXXX XXX XXX X XXXXXXXXX X X XXX X
XOXOXBOBXOXBOBXBOOXOXBOBXBOBOBXBOOOBXBOBXB   B   BXBOBX X XB  XB BX  B BX XB BX XB   BXB   BX XB BX X
XOXOXXXOXXXOXOXXXXXOXOXXXXXOXOXOXXXOXOXXXXXXX XXX XOXXX X X XXXXXXXXX XXX XXX X X XXX X XXXXX XXX XXX
XBOBXBOBXBOBXOXBOBXBOBOOOBXOXOXOXBOBXOXB     BXB BXBOBXB BXB B   BXB BXB BXB BX X X XB BX  BX X XB BX
XOXXXOXOXOXXXOXOXOXXXXXXXOXXXOXOXOXXXOX XXXXXXX XXXXXOX XXXXX XXX X XXX XXX XXX X X XXXXXXX X X XXX X
XOXBOBXOXOXOXBOBXBOOOBXOOBOBXOXOXBOOOBXB   BX XB  XBOBX XB   BX  BX X XB   BXB BXB B BXB BX X X XB BX
XXXOXXXOXOXOXXXXXXXXXOXXXXXOXOXOXXXXXXXXXXX X X XXXOXXX X XXXXXXX X X X XXXXX XXXXXXX X X X X X X X X
XBOBXBOBXBOBXBOOOOOBXBOBXBOBXOXBOBXBOOOOOBX X X XBOBX  BXB     BXB BX XB    X XB     B BXB BXB BX X X
XOXXXOXXXXXOXOXXXXXOXXXOXOXXXOXXXOXOXXXXXOX X X XOXXXXX XXXXXXX XXXXX X XXXXX X XXXXXXXXXXX XXX X X X
XOXOOBXBOOOBXBOOOBXOXBOBXBOOOBOBXOXOXBOOOBX X X XOXBOBXB       BX  BXB BXB BX X XB BX  BXB BXB BX X X
XOXXXXXOXXXXXXXXXOXOXOXXXXXXXXXOXOXOXOXXXXX X X XOXOXOXXXXXXXXXXXXX X XXX X X XXX X XXX X XXX XXX X X
XOXBOOOBXBOBXBOBXOXBOBXBOBXBOOOBXBOBXOX  B BXB BXBOBXBOOOBX      B BXB BX XB BXB BXB BXB B  X XB BX X
XOXOXXXXXOXOXOXOXOXXXXXOXOXOXXXXXXXXXOXXX XXXXX XXXXXXXXXOXXXXXXX XXXXX X XXXXX XXXXX XXXXXXX X XXXXX
XOXOXOXBOBXBOBXBOBXBOOOBXOXBOBXOOOOBXBOBXB   BXB     B  XBOOOOOBXB B  X XB BXB BXB BX XB   BX XB   BX
XOXOXOXOXOXXXXXXXXXOXXXXXXXXXOXXXXXOXXXOX XXX XXXXXXX XXXXXXXXXOXXX XXX XXX X XXX X X X XXX X XXXXX X
XOXBOBXOXOXBOOOBXOOBOOOOOBXBOBXBOBXOXBOBXB BX XB BXB BXBOOOBOOXBOBXB BX X XB BXB BX XB BXB BX XB   BX
XOXXXOXOXOXOXXXOXXXOXXXXXOXOXXXOXOXOXOXXXXX X X X X XXXOXXXOXXXXXOX X X X XXXXX XXX XXXXX X X X XXXXX
XBOOOBXOXOXOXOXBOBXBOOOOXBOBOBOBXBOBXOX    BXB BX XB BXOXOXBOOOBXOX XB B BXB BXB BX X XB BX X XB   BX
XOXXXXXOXXXOXOXXXOXXXXXXXXXXXOXXXXXOXOXXXXXXXXX X XXX XOXOXXXXXOXOXXXXXXX X X XXX X X X XXXXX XXXXX X
XBOOOOXOXBOBXOXBOBXBOBXBOOOBXOXBOBXOXBOOOOOOOBX XB BX XOXBOOOOXBOBXBOOOBXB BXB BX XB BXB     BXB   BX
XOXXXXXOXOXXXOXOXXXOXOXOXXXOXXXOXOXOXXXXXXXXXOXXXXX X XOXOXXXXXXXXXOXXXOXXXXXXX X XXX XXXXXXXXX XXXXX
XOXBOBXOXBOBXOXOXBOBXBOBX XBOBXOXOXOXOXBOOOOOBXB BX X XOXBOBOOOOOBOBXOXOX    B BX X X XB     BXB   BX
XXXOXOXOXXXOXOXOXOXXXXXXX XXXOXOXOXOXOXOXXXXXXX X X X XOXXXOXXXXXOXXXOXOXXXXX XXX X X X XXXXX XXXXX X
XBOBXBOBOOXBOBXOXOXB   BXB BXOXOXOXBOBXOXB  XB BXB BX XBOBXOXBOOOBXBOBOBXBOBXB BX XB BX XB   B BX X X
XOXOXXXXXXXXXOXOXOX XXX X X XOXOXOXXXXXOX XXX X XXXXX XXXOXXXOXXXXXOXXXXXOXOXXX X X XXXXX XXXXX X X X
XOXOXBOBXBOOOBXOXOXB BX X X XBOBXBOBXBOBXB BX XB BX X X XBOOOBX XBOBXBOBOBXOX XB BXB     BXB  XB BX X
XOXXXOXOXOXXXXXOXOX X X X X XXXXXXXOXOXXX X X XXX X X X XXXXXXX XOXXXOXOXXXOX XXXXX XXXXXXX XXXXX X X
XOXBOBXOXBOOOBXBOBX X X X XB     BXOXBOBX XB B  X X X XB BXB B BXBOBXOXOXOOBX XB   BXBOBX XB     BX X
XOXOXXXOXXXXXOXXXXX X XXX XXXXXXX XOXXXOX XXXXXXX X X X X X X XXXXXOXOXOXXXOX X XXXXXOXOX X XXXXXXX X
XOXOXBOBOOOOXBOBX  BXB   B  XB BX XBOOXOXB BX XB BXB BX X X XB B BXOXOXBOBXOXB B    XOXOXB B   BX X X
XOXOXOXXXXXXXXXOXXXXXXXXXXXXX X X XOXXXOXXX X X XXX XXX X X XXX X XOXOXXXOXOXXXXXXXXXOXOXXXXXXX X X X
XBOBXBOOOBXBOOOBXB         BX XB BXBOBXOX X X X X XB BX XB BXB BX XOXOXBOBXBOOOBXBOOOBXOXBOOOBXB BX X
XXXXXXXXXOXOXXXXX XXXXXXXXX X XXX XXXOXOX X X X X XXX XXXXXXX XXXXXOXXXOXXXXXXXOXOXXXXXOXOXXXOXXX X X
X  B BX XBOBXB   B   BX    B BX  B  XBOBX XB BX XB   B     BXB   BXBOOOBX    BXOXBOBXBOBXOXOOBOBX X X
XXX X X XXXXX XXXXXXX XXXXX XXXXXXXXXXXXX XXX X X XXXXXXXXX XXXXX XXXXXXXXXXX XOXXXOXOXXXOXXXXXOXXX X
XB BX XB   BXB   BX X XB BX XB   BXB     B   BX XB  XB BX X XB   B         BX XBOBXOXBOBXBOBXOXBOBX X
X XXX X XXX XXXXX X X X X XXX XXX X XXXXXXXXXXX XXXXX X X X X XXXXXXXXXXXXX X XXXOXOXXXOXXXOXOXXXOX X
XB BXB BXB BXB BXB BXB BX XB BX XB BX  B   BXB BXB BX X XB B BXB   BXB BX XB BX XOXBOBXOXBOBXOXBOBX X
X X XXXXX XXX X XXXXX XXX X XXX XXXXXXX XXX X XXX X X X XXXXXXX XXX X X X XXX X XOXXXOXOXOXXXOXOXXX X
X X X    B BX XB   BXB  X X X  B B B B BX  BXB   BXB BXB     BX X XB BX XB   BX XBOOOBXBOBXBOBXBOBX X
X X XXXXXXX X XXXXX XXXXX X XXXXX X X XXXXXXXXXXXXXXXXXXXXXXX X X XXXXX X XXXXX XXXXXXXXXXXOXOXXXOX X
X XB     BXB BXB BXB B   BXB   BX X X XB       B BXB B     BXB BX XB   BXB     BXB BXBOOOOOBXBOBXOX X
X XXXXXXX XXXXX X XXX XXXXXXXXX X X X X XXXXXXX X X X XXXXX XXXXX X XXXXXXXXXXX X X XOXXXXXXXXXOXOX X
XB BXB BXB   BX XB BX XB       BX X X X X    BX X X X XB  X XB   BXB     BXB BXB BX XOX  BXB BXBOBX X
XXX X X XXXXX X XXX X X XXXXXXXXX X XXX XXXXX X X XXX X XXX X XXX XXXXXXX X X X XXXXXOXXX X X XXXXX X
XB BX XB   BXB BX X X X XB BXB BX XB BXB B   BX XB   BXB   B BXB B  XB BX X X X XBOBXOXB BX XB     BX
X XXX XXXXX XXXXX X XXX X X X X X XXX XXX XXXXX XXXXX XXXXXXXXX XXXXX X X X XXX XOXOXOX XXX XXXXXXX X
XB   BXB   BX    BXB   BX XB BXB B BXB   BXB   BXB BX XB BX XB BXB   BXB BXB B BXOXBOBXB   BX XBO  BX
XXXXXXX XXXXXXXXX XXXXXXXXXXX XXXXX XXXXXXX XXXXX X XXX X X X XXX XXXXXXXXXXX XXXOXXXXX XXXXX XOXXXXX
XB BX XB         BXB       BX XB BX X XB BXB     BXB   BX X XB BXB BXB BXB BX XBOBXB BXB   BX XBOOOBX
X X X XXXXXXXXXXX X XXXXXXX X X X X X X X XXXXXXXXXXXXXXX X XXX XXX X X X X X XOXXX X XXXXX X XXXXXOX
X XB B    XB     BXB   BXB BX X X XB BX XB     BXB     BX XB BX X XB BX X X X XBOBX XB B BX XB BXBOBX
X XXXXXXXXX XXXXXXX XXX X XXXXX X XXXXX XXXXXXX X XXXXX X X X X X XXXXX X X XXXXXOX XXX X X X X XOXOX
XB   BXB   BXB BXB B  X XB     BXB     BX XB   BX XB   BX X X X XB    XB BXB BXBOBXB BX X XB BX XOXOX
XXXXX X XXXXX X X XXXXX XXXXXXXXXXXXXXXXX X XXXXX X XXXXX X X X X XXXXXXXXXXX XOXXXXX X XXXXXXX XOXOX
XB   BX XB   BX XB  XB BX  B      XB   BXB BXB BX XB BXB BX XB BXB BXBOOOOOBX XBOOOBX XB B     BXOXOX
X XXXXX X XXXXX XXXXX XXXXX XXXXXXX XXX X XXX X X XXX X XXX XXXXX X XOXXXXXOX XXXXXOXXXXX XXXXX XOXOX
X XB BXB BXB BXB BXB BXB   BXB   BX X X X XB BX X X X X X XB BX  BX XBOOOBXBOB    XBOOOBX XBOBX XOXOX
X X X XXXXX X XXX X XXX XXXXX XXX X X X X X XXX X X X X X XXX XXXXX XXXXXOXXXXXXXXXXXXXOXXXOXOXXXOXOX
XB BXB     BXB   B BX  B     B  XB B BXB B BX  B BXB B BXB   B     B    XBOOOOOOOOOOOOOBOOOBXBOOOBXBK
XXXXXXXXXXXXXXXXXXXXXXXXXXXXXXXXXXXXXXXXXXXXXXXXXXXXXXXXXXXXXXXXXXXXXXXXXXXXXXXXXXXXXXXXXXXXXXXXXXXXX
